Z                            Z
Z                            Z
Z                            Z
Z                            Z
Z                            Z
Z                            Z
Z                            Z
Z                            Z
Z                            Z
Z                            Z
Z                            Z
Z                            Z
Z                            Z
Z                            Z
Z                            Z
Z                            Z
Z                            Z
ZF            D             EZ
ZZZZZZZZZZZZZZZZZZZZZZZZZZZZZZ
Z             H              Z
Z             H              Z
Z             H              Z
Z             H              Z
Z             H              Z
Z             H              Z
Z             H              Z
Z             H              Z
Z             H              Z
Z     P       S              Z
ZZZZZZZZZZZZZZZZZZZZZZZZZZZZZZ