Z                            Z
Z      D  F    E             Z
Z      ZZZZZZZZZZZ           Z
Z      H                     Z
Z      S        D            Z
ZZZZZZZZZZZZZ  ZZZZZZZZZZZZZZZ
Z               H            Z
Z            E  S            Z
ZZZZZ  ZZZZZZZZZZZZZZZZZZ  ZZZ
Z    Z                    Z  Z
Z     Z       D          Z   Z
Z      ZZZZZZZZZZZZZZZZZZ    Z
Z             H              Z
Z      D      S              Z
Z    ZZZZZ  ZZZZZ  ZZZZZ  ZZZZ
Z      H      Z         Z    Z
Z  D   S   E  Z          Z D Z
ZZZZZZZZZZZZZZZZZZZZZZZZZZZZZZ
Z  H                       H Z
Z  S           E           S Z
ZZZZZZZZZ  ZZZZZZZZZZZZZZZZZZZ
Z        Z                   Z
Z         Z             E   DZ
ZZZZZZZZZZZZZZZZZZZZZZZZZZZZZZ
Z                           HZ
Z    P                      SZ
ZZZZZZZZZZZZZZZZZZZZZZZZZZZZZZ